{'P':-1, 'Q': 5}
###############
# # @     #   #
# # ####### ###
# # #     #   #
# # # # # ### #
# #   # # #Q# #
# # # # # # # #
# # # # # # # #
#   #   #     P
###############
